ANCIEN CHEMIN ANC CHEM	ACH
ANCIEN CHEMIN ANCIEN CHEMIN	ACH
ANCIENNE ROUTE ANC RTE	ART
ANCIENNE ROUTE ANCIENNE ROUTE	ART
CHEMIN RURAL DIT CHEM	CHE
CHEMIN RURAL DIT CHEMIN	CHE
CHEMIN RURAL DIT RUELLE	RLE
CHEMIN RURAL DIT VOIE	VOIE
CITE CITES	CITES
CITE CITE	CITE
GRANDE RUE GRAND RUE	GR
GRANDE RUE GRANDE RUE	GR
GRANDE RUE GDE RUE	GR
PETIT CHEMIN PT CHEM	PCH
PETIT CHEMIN PT CHEMIN	PCH
PETIT CHEMIN PETIT CHEM	PCH
PETITE ALLEE PTE ALL	PTA
PETITE ALLEE PTE ALLEE	PTA
PETITE AVENUE PET AVE	PAE
PETITE AVENUE PTE AVE	PAE
PETITE RUE PETITE RUE	PTR
PETITE RUE PTE RUE	PTR
ROND POINT ROND POINT	RPT
VOIE COMMUNALE DITE VOIE	VOIE
VIEILLE ROUTE VIEILLE ROUTE	VTE
VIEILLE ROUTE VIEILLE RTE	VTE
VIEUX CHEMIN VIEUX CHEMIN	VCHE
ACH ANC CHEM	ACH
ACH ANCIEN CHEMIN	ACH
ART ANC RTE	ART
CHE ANC CHE	ACH
CHE ANC CHEM	ACH
CHEMIN ANC CHE	ACH
CHEMIN ANC CHEM	ACH
CHEMIN COMMUNAL HENT	HENT
CHEMIN RURAL DIT	CR
CHEMIN RURAL HENT	HENT
CR DIT CHEMIN	CHE
GR GDE RUE	GR
GR GR RUE	GR
GR GRANDE RUE	GR
GRANDE RUE GR	GR
GRANDE RUE RUE	GR
PAE PET AVE	PAE
PAE PTE AVE	PAE
PCH PET CHE	PCH
PCH PETIT CHEMIN	PCH
PTR PETITE RUE	PTR
PTR PTE RUE	PTR
RPT ROND POINT	RPT
ROUTE ANCIENNE ROUTE	ART
RTE ANCIENNE ROUTE	ART
RUE DITE ENTREE	ENTREE
RUE GRANDE RUE	GR
RUE PETITE RUE	PTR
VCHE VIEUX CHEMIN	VCHE
VOIE COMMUNALE ALEZ	ALEZ
VOIE COMMUNALE DITE	VOIE
VOIE COMMUNALE HENT	HENT
VOIE COMMUNALE KOAD	KOAD
VOIE COMMUNALE PGE	PAS
VOIE COMMUNALE PLASENN	PLASENN
VOIE COMMUNALE STR	SEN
VOIE COMMUNALE VOIE	VOIE
ALL ALEZ	ALEZ
ANCIEN CHEMIN	ACH
ANCIENNE ROUTE	ART
AV AVENUE	AV
CC HENT	HENT
CHE HENT	HENT
CHEM HENT	HENT
CHEMIN COMMUNAL	CC
CHEMIN DEPARTEMENTAL	CD
CHEMIN FORESTIER	CF
CHEMIN HENT	HENT
CHEMIN RURAL	CR
CHEMIN VICINAL	CHV
CR DIT	CR
ESP ESPLANADE	ESP
GRAND BOULEVARD	GBD
GRAND PLACE	GPL
GR GR	GR
GR GRANDE	GR
GRAND RUE	GR
GRANDE RUE	GR
IMP HENT	HENT
IMPASSE HENT	HENT
NOUVELLE ROUTE	NTE
PAS PGE	PAS
PASSAGE PGE	PAS
PETIT CHEMIN	PCH
PETITE ALLEE	PTA
PETITE AVENUE	PAE
PETITE ROUTE	PRT
PETITE RUE	PTR
ROND POINT	RPT
RUE ALEZ	ALEZ
RUE HENT	HENT
RUE STRAED	STRAED
RUE STREAT	STRAED
RUE RU	RU
RUE RUE	RUE
VC ALEZ	ALEZ
VC BOUCLE	BCLE
VC HENT	HENT
VC KOAD	KOAD
VC PGE	PAS
VC PLASENN	PLASENN
VC STE	SEN
VC STR	SEN
VC VIADUC	VIAD
VC VOIE	VOIE
VEN HENT	HENT
VENELLE HENT	HENT
VOIE COMMUNALE	VC
VIEILLE ROUTE	VTE
VIEILLE RTE	VTE
VIEUX CHEMIN	VCHE
AGGLOMERATION	AGL
AERODROME	AER
AIRE	AIRE
ALLEE	ALL
ALLEES	ALL
ANGLE	ANGL
ARCADE	ARC
AUTOROUTE	AUT
AVENUE	AV
BARRIERE	BRE
BASE	BASE
BASSIN	BSN
BERGE	BER
BORD	BORD
BOUCLE	BCLE
BOULEVARD	BD
BOURG	BRG
BRETELLE	BRTL
CARRER	CAE
CARRIERA	CAE
CALLE	CALL
CAMIN	CAMI
CAMP	CAMP
CANAL	CAN
CARREFOUR	CAR
CARRIERE	CARE
CASERNE	CASR
CHASSE	CHA
CHEM	CHE
CHEMIN	CHE
CHEMINEMENT	CHE
CHALET	CHL
CHAMP	CHP
CHAUSSEE	CHS
CHATEAU	CHT
CITE	CITE
COURSIVE	CIVE
CLOS	CLOS
COULOIR	CLR
COIN	COIN
COL	COL
CORNICHE	COR
CORON	CORO
COTE	COTE
COUR	COUR
CAMPING	CPG
COURS	CRS
CROIX	CRX
CONTOUR	CTR
CENTRE	CTRE
DARSE	DARS
DEVIATION	DEVI
DIGUE	DIG
DOMAINE	DOM
DRAILLE	DRA
DESCENTE	DSC
ÉCART	ECA
ECLUSE	ECL
EMBRANCHEMENT	EMBR
ENCLOS	ENC
ENCLAVE	ENV
ESCALIER	ESC
ESPLANADE	ESP
ESPACE	ESPA
ETANG	ETNG
FOND	FD
FAUBOURG	FG
FBG	FG
FONTAINE	FON
FORT	FORT
FOSSE	FOS
FERME	FRM
GALERIE	GAL
GARE	GARE
GROUPE	GRP
GRPE	GRP
HABITATION	HAB
HAMEAU	HAM
HALLE	HLE
HALAGE	HLG
HLM	HLM
ÎLE	ILE
ILOT	ILOT
IMPASSE	IMP
JARDIN	JARD
JETEE	JTE
LAC	LAC
LEVEE	LEVE
LICES	LICE
LIGNE	LIGN
LOTISSEMENT	LOT
MAIL	MAIL
MAISON	MAIS
MARCHE	MAR
MAS	MAS
MARINA	MRN
MONTEE	MTE
PARC	PARC
PASSAGE	PAS
PASSE	PASS
PHARE	PHAR
PISTE	PIST
PARKING	PKG
PLACE	PL
PLACA	PLA
PLAGE	PLAG
PLAN	PLAN
PLACIS	PLCI
PASSERELLE	PLE
PGE	PAS
PLAINE	PLN
PLATEAU	PLT
POINTE	PNT
PONT	PONT
PORTIQUE	PORQ
PORT	PORT
POSTE	POST
POTERNE	POT
PROMENADE	PROM
PARVIS	PRV
PLACETTE	PTTE
PORTE	PTE
QUAI	QUAI
QRT	QUA
QUARTIER	QUA
RACCOURCI	RAC
RAMPE	RPE
RAIDILLON	RDL
RAVIN	RAV
RAVINE	RVE
REMPART	REM
RESIDENCE	RES
RIVE	RIVE
ROCADE	ROC
ROTONDE	RTD
ROUTE	RTE
RUE	RUE
RUELLE	RLE
RUELLETTE	RULT
RUETTE	RUET
RUISSEAU	RUIS
SAS	SAS
SENTE	SEN
SENTIER	SEN
SQUARE	SQ
STADE	STDE
TOUR	TOUR
TERRE PLEIN	TPL
TRAVERSE	TRA
TRABOULE	TRAB
TERRAIN	TRN
TERTRE	TRT
TERRASSE	TSSE
TUNNEL	TUN
VAL	VAL
VALLON	VALL
VENELLE	VEN
VILLAGE	VGE
VIA	VIA
VIADUC	VIAD
VILLE	VIL
VILLA	VLA
VOIE	VOIE
VOIRIE	VOIR
VOUTE	VOUT
VOYEUL	VOY
ZA	ZA
ZAC	ZAC
ZAD	ZAD
ZI	ZI
ZONE	ZONE
ZUP	ZUP
