# Format des lignes : <chaine a trouver><tabulation><chaine de remplacement>
B.C.P	BATAILLON DE CHASSEURS A PIEDS
CHARLES DE GAUL	CHARLES DE GAULLE
CHP	CHAMP
DOCT	DOCTEUR
DELATTRE DE TASSIGNY	DE LATTRE DE TASSIGNY
ENFTS	ENFANTS
FBG	FAUBOURG
FG  FAUBOURG
FBOURG  FAUBOURG
GDS	GRANDS
GDES	GRANDES
N D	NOTRE DAME
N DAME	NOTRE DAME
NVE	NEUVE
ORADOUR SURGLANE	ORADOUR SUR GLANE
PGE	PASSAGE
R.A.M	REGIMENT D ARTILLERIE DE MONTAGNE
R.T.M.	REGIMENT DE TIRAILLEURS MAROCAINS
RD PERE	REVEREND PERE
